It has been 1000 years since the Last Sundering, when the evil that sleeps on the edge of the world was banished again, as it has been for millenia. But now, the Ancient Fog has risen, and in the mist demons have awoken. As beasts of legend once again take shape and weave their devastation across the land, heroes from around the world have taken up arms in the defense of their home. And of course, somebody has to sell them their weapons...

The Salesman
An Interactive Fiction by Arthur Berman
Release 1 / Serial number 140313 / Inform 7 build 6G60 (I6/v6.32 lib 6/12N) SD

store
You stand behind the counter of your Adventuring Supply Store. Various customers mill about as they examine your various goods. Your sword leans against the wall, but you're a merchant and don't have the strength or skill needed to fight with such a weapon. 

You can also see a Front Door, Matthias Greyhammer and Gerome Slowarm here.

>go east
Waterfall
There is a waterfall

>go west
Store
You stand behind the counter and watch as various people do stuff.

* * *

>open the Front Door
You open the Front Door.

>go through the front door
town square
You can see a Front Door and Matthias Greyhammer here.

* * *

>open the door
You open the Front Door.

>go through the door
town square
You can see Matthias Greyhammer here.

>talk to Matthias
That's not a verb I recognise.

>say "Hi Matthias"
(to Matthias Greyhammer)
There is no reply.

* * *

>go north
town square
The once-bustling town square is eerily quiet. The black mist that lingers across the world is thin here, but still present. Apart from the city guards, the only other person in the square is an old woman, who you recognize as Muriel, the Witch. The city walls loom overhead to the north and east. The church is to the west, with its enormous gates open to anybody willing to donate.

You can see a church door, a Front Door, a cat and Muriel here.

>examine Matthias Greyhammer
A stout man in leather armor.

>look at Matthias Greyhammer
A stout man in leather armor.

* * *

>go north
town square
The once-bustling town square is eerily quiet. The black mist that lingers across the world is thin here, but still present. Apart from the city guards, the only other person in the square is an old woman, who you recognize as Muriel, the Witch. The city walls loom overhead to the north and east. The church is to the west, with its enormous gates open to anybody willing to donate.

You can see a church door, a Front Door, a cat and Muriel here.

>examine muriel
A wizened old crone wearing a ragged cloak. An oily, slick lock of hair droops across her forehead, but her head is otherwise bald. A bag slung across her shoulder wriggles slightly.

* * *

>go north
town square
The once-bustling town square is eerily quiet. The black mist that lingers across the world is thin here, but still present. Apart from the city guards, the only other person in the square is an old woman, who you recognize as Muriel, the Witch. The city walls loom overhead to the north and east. The church is to the west, with its enormous gates open to anybody willing to donate.

You can see a church door, a Front Door, a cat and Muriel here.

>go north
North Wall
This immense wall may be the only thing protecting the town from certain destruction. An enormous gate stands barred and locked. If any of the demons were to attack, surely this wall would stop them... You can go up the wall.

You can see a main gate here.

>go up
The Top of the Wall
You can see an enormous bank of fog.

>go south
You can't go that way.

>go down
North Wall
This immense wall may be the only thing protecting the town from certain destruction. If any of the demons were to attack, surely this wall would stop them... You can go up the wall.

>up
The Top of the Wall
You can see an enormous bank of fog.

>down
North Wall
This immense wall may be the only thing protecting the town from certain destruction. If any of the demons were to attack, surely this wall would stop them... You can go up the wall.

* * *

>go up
The Top of the Wall
You can see an enormous bank of fog.

>examine it
You see nothing unexpected in that direction.

>examine the enormous bank of fog
This obscuring cloud almost seems to growl menacingly. Looking at it hurts the eyes, not because it is bright but because it seems to sap light from the space in front of you.

>quit
Are you sure you want to quit?

>ys
Please answer yes or no.

* * *

>go north
North Wall
This immense wall may be the only thing protecting the town from certain destruction. An enormous gate stands barred and locked. If any of the demons were to attack, surely this wall would stop them... You can go up the wall.

You can see a main gate here.

>go north
(first opening the main gate)
It seems to be locked.

>go north
(first opening the main gate)
It seems to be locked.

>go up
The Top of the Wall
You can see an enormous bank of fog.

* * *

>go north
North Wall
This immense wall may be the only thing protecting the town from certain destruction. An enormous gate stands barred and locked. If any of the demons were to attack, surely this wall would stop them... You can go up the wall.

You can see a main gate here.

>go west
town hall
Once the center of government in the city, the town hall is now deserted.

You can see a gate key here.

>take the gate key
Taken.

>go east
North Wall
This immense wall may be the only thing protecting the town from certain destruction. An enormous gate stands barred and locked. If any of the demons were to attack, surely this wall would stop them... You can go up the wall.

You can see a main gate here.

>go north
(first opening the main gate)
It seems to be locked.

>open the main gate
It seems to be locked.

>use the gate key on the main gate
That's not a verb I recognise.

>open the main gate with the gate key
You unlock the main gate.

>go north
(first opening the main gate)
You can't, since the main gate leads nowhere.

* * *

>go east
North Wall
This immense wall may be the only thing protecting the town from certain destruction. An enormous gate stands barred and locked. If any of the demons were to attack, surely this wall would stop them... You can go up the wall.

You can see a main gate here.

>open the main gate with the gate key
You unlock the main gate.

>go north
(first opening the main gate)
By opening the gate, you have allowed the monsters entrance to the city. Demons and monsters wreak havoc and destroy everything in their reach, starting with you.

    *** The End ***

In that game you scored 0 out of a possible 0, in 7 turns.

Would you like to RESTART, RESTORE a saved game, QUIT or UNDO the last command?

>restart
It has been 1000 years since the Last Sundering, when the evil that sleeps on the edge of the world was banished again, as it has been for millenia. But now, the Ancient Fog has risen, and in the mist demons have awoken. As beasts of legend once again take shape and weave their devastation across the land, heroes from around the world have taken up arms in the defense of their home. And of course, somebody has to sell them their weapons...

The Salesman
An Interactive Fiction by Arthur Berman
Release 1 / Serial number 140313 / Inform 7 build 6G60 (I6/v6.32 lib 6/12N) SD

store
You stand behind the counter of your Adventuring Supply Store. Various customers mill about as they examine your various goods. You have a sword, but you're a merchant and don't have the strength or skill needed to fight with such a weapon.

You can also see a Front Door, Matthias Greyhammer and Gerome Slowarm here.

>go north
town square
The once-bustling town square is eerily quiet. The black mist that lingers across the world is thin here, but still present. Apart from the city guards, the only other person in the square is an old woman, who you recognize as Muriel, the Witch. The city walls loom overhead to the north and east. The church is to the west, with its enormous gates open to anybody willing to donate.

You can see a church door, a Front Door, a cat and Muriel here.

>take the cat
The cat scurries away.

>look
town square
The once-bustling town square is eerily quiet. The black mist that lingers across the world is thin here, but still present. Apart from the city guards, the only other person in the square is an old woman, who you recognize as Muriel, the Witch. The city walls loom overhead to the north and east. The church is to the west, with its enormous gates open to anybody willing to donate.

You can see a church door, a Front Door and Muriel here.

>go to the store
You can't see any such thing.

>go south
store
You stand behind the counter of your Adventuring Supply Store. Various customers mill about as they examine your various goods. You have a sword, but you're a merchant and don't have the strength or skill needed to fight with such a weapon.

You can also see a Front Door, Matthias Greyhammer and Gerome Slowarm here.

>take the sword
Taken.

* * *

>restart
Are you sure you want to restart?

>yes
It has been 1000 years since the Last Sundering, when the evil that sleeps on the edge of the world was banished again, as it has been for millenia. But now, the Ancient Fog has risen, and in the mist demons have awoken. As beasts of legend once again take shape and weave their devastation across the land, heroes from around the world have taken up arms in the defense of their home. And of course, somebody has to sell them their weapons...

The Salesman
An Interactive Fiction by Arthur Berman
Release 1 / Serial number 140313 / Inform 7 build 6G60 (I6/v6.32 lib 6/12N) SD

store
You stand behind the counter of your Adventuring Supply Store. Various customers mill about as they examine your various goods. You have a sword, but you're a merchant and don't have the strength or skill needed to fight with such a weapon.

You can also see a Front Door, Matthias Greyhammer and Gerome Slowarm here.

>take the swor
You can't see any such thing.

>take the sword
Taken.

* * *

>take the sword
Taken.

>drop the sword
Dropped.

* * *

>take the sword
Taken.

* * *

>go north
town square
The once-bustling town square is eerily quiet. The black mist that lingers across the world is thin here, but still present. Apart from the city guards, the only other person in the square is an old woman, who you recognize as Muriel, the Witch. The city walls loom overhead to the north and east. The church is to the west, with its enormous gates open to anybody willing to donate.

You can see a church door, a Front Door, a cat and Muriel here.

>go west
church
The church has never been this empty. A chorus of prayers drifts ethereally through the building, but nobody is here save for the priest.

You can see a church door here.

>talk to the priest
You can't see any such thing.

>quit
Are you sure you want to quit?

* * *

>go north
town square
The once-bustling town square is eerily quiet. The black mist that lingers across the world is thin here, but still present. Apart from the city guards, the only other person in the square is an old woman, who you recognize as Muriel, the Witch. The city walls loom overhead to the north and east. The church is to the west, with its enormous gates open to anybody willing to donate.

You can see a church door, a Front Door, a cat and Muriel here.

>examine the cat
You see nothing special about the cat.

>talk to muriel
Muriel says, "Bug off, you twit. I don't want any of what you're selling. Won't do no good neither. Keh-heh-heh-heh."

>interact iwth muriel
That's not a verb I recognise.

>interact with muriel
That's not a verb I recognise.

* * *

>take sword
Taken.

>inventor
That's not a verb I recognise.

>inventory
You are carrying:
  a sword

* * *

>take sword
Taken.

>sell the sword to gerome slowarm
Gerome thanks you for the fine sword, and gladly parts with 150 points.

[Your score has just gone up by one hundred and fifty points.]

>wait
Time passes.

>wait
Time passes.

>ait
That's not a verb I recognise.

>ait
That's not a verb I recognise.

>wait
Time passes.

>wait
Time passes.

A horrifying roar fills the air.

>wait
Time passes.

Screams and cries ring out.

>wait
Time passes.

A monstrous shadow covers the store.

>wait
Time passes.

A beast with one-thousand eyes peers down from the sky above. Clearly the enormous walls were inadequate to keep this monster out.

Gerome Slowarm takes his new sword and charges the horrifying beast, and is summarily squelched by three tons of demon-claw.

>wait
Time passes.

The Beast inhales, and a horrible miasma oozes from his throat. He is about to drown the city in death. 

Alas, the horrifying demonic beast has overwhelmed the city, and in so doing has ended your life. If only you had been a better businessman and sold some goods to somebody who could defend the city.

    *** The End ***

In that game you scored 150 out of a possible 0, in 15 turns.

Would you like to RESTART, RESTORE a saved game, QUIT or UNDO the last command?

>restart
It has been 1000 years since the Last Sundering, when the evil that sleeps on the edge of the world was banished again, as it has been for millenia. But now, the Ancient Fog has risen, and in the mist demons have awoken. As beasts of legend once again take shape and weave their devastation across the land, heroes from around the world have taken up arms in the defense of their home. And of course, somebody has to sell them their weapons...

The Salesman
An Interactive Fiction by Arthur Berman
Release 1 / Serial number 140313 / Inform 7 build 6G60 (I6/v6.32 lib 6/12N) SD

store
You stand behind the counter of your Adventuring Supply Store. Various customers mill about as they examine your various goods. You have a sword, but you're a merchant and don't have the strength or skill needed to fight with such a weapon. 

You can also see a Front Door, Matthias Greyhammer and Gerome Slowarm here.

>take sword
Taken.

>sell sword to Matthias
I didn't understand that sentence.

>sell the sword to matthias
Matthias thanks you for the fine sword, at such a reasonable price. He gives you 100 points in exchange.

[Your score has just gone up by one hundred points.]

>wait
Time passes.

* * *

>wait
Time passes.

A monstrous shadow covers the store.

>wait
Time passes.

A beast with one-thousand eyes peers down from the sky above. Clearly the enormous walls were inadequate to keep this monster out.

Matthias Greyhammer takes his newly acquired sword and slays the horrifying beast that threatens the town. You are safe and able to sell your wares for another day, but how much longer will this uneasy safety last?

    *** You have won ***

In that game you scored 100 out of a possible 0, in 13 turns.

Would you like to RESTART, RESTORE a saved game, QUIT or UNDO the last command?

>wait
Please give one of the answers above.

Would you like to RESTART, RESTORE a saved game, QUIT or UNDO the last command?

* * *

>exit
But you aren't in anything at the moment.